Heavenly Inferno - Kaalia of the Vast  (Commander 2011)
Mirror Mastery - Riku of Two Reflections  (Commander 2011)
Counterpunch - Ghave, Guru of Spores  (Commander 2011)
Political Puppets - Zedruu the Greathearted (Commander 2011)
Devour for Power - The Mimeoplasm (Commander 2011)
Evasive Maneuvers - Derevi, Empyrial Tactician (Commander 2013)
Eternal Bargain - Oloro, Ageless Ascetic (Commander 2013)
Mind Seize - Jeleva, Nephalia's Scourge (Commander 2013)
Power Hungry - Prossh, Skyraider of Kher (Commander 2013)
Nature of the Beast - Marath, Will of the Wild (Commander 2013)
Forged in Stone - Nahiri, the Lithomancer (Commander 2014)
Peer Through Time - Teferi, Temporal Archmage (Commander 2014)
Sworn to Darkness - Ob Nixilis of the Black Oath (Commander 2014)
Built from Scratch - Daretti, Scrap Savant (Commander 2014)
Guided by Nature - Freyalise, Llanowar's Fury (Commander 2014)
Call the Spirits - Daxos the Returned (Commander 2015)
Seize Control - Mizzix of the Izmagnus (Commander 2015)
Plunder the Graves - Meren of Clan Nel Toth (Commander 2015)
Wade into Battle - Kalemne, Disciple of Iroas (Commander 2015)
Swell the Host - Ezuri, Claw of Progress (Commander 2015)
Entropic Uprising - Yidris, Maelstrom Wielder (Commander 2016)
Open Hostility - Saskia the Unyielding (Commander 2016)
Stalwart Unity - Kynaios and Tiro of Meletis (Commander 2016)
Breed Lethality - Atraxa, Praetors' Voice (Commander 2016)
Invent Superiority - Breya, Etherium Shaper (Commander 2016)
Draconic Domination - The Ur-Dragon (Commander 2017)
Feline Ferocity - Arahbo, Roar of the World (Commander 2017)
Vampiric Bloodlust - Edgar Markov (Commander 2017)
Arcane Wizardry - Inalla, Archmage Ritualist (Commander 2017)
Exquisite Invention - Saheeli, the Gifted (Commander 2018)
Nature's Vengeance - Lord Windgrace (Commander 2018)
Adaptive Enchantment - Estrid, the Masked (Commander 2018)
Subjective Reality - Aminatou, the Fateshifter (Commander 2018)
Faceless Menace - Kadena, Slinking Sorcerer (Commander 2019)
Mystic Intellect - Sevinne, the Chronoclasm (Commander 2019)
Primal Genesis - Ghired, Conclave Exile (Commander 2019)
Merciless Rage - Anje Falkenrath (Commander 2019)
Symbiotic Swarm  - Kathril, Aspect Warper (Commander 2020)
Ruthless Regiment - Jirina Kudro (Commander 2020)
Timeless Wisdom - Gavi, Nest Warden (Commander 2020)
Arcane Maelstrom - Kalamax, the Stormsire (Commander 2020)
Enhanced Evolution - Otrimi, the Ever-Playful (Commander 2020)
Land's Wrath - Obuun, Mul Daya Ancestor (Zendikar Rising Commander Decks)
Sneak Attack - Anowon, the Ruin Thief (Zendikar Rising Commander Decks)
Arm for Battle - Wyleth, Soul of Steel (Commander Legends Commander Decks)
Reap the Tides - Aesi, Tyrant of Gyre Strait (Commander Legends Commander Decks)
Elven Empire - Lathril, Blade of the Elves (Kaldheim Commander Decks)
Phantom Premonition - Ranar the Ever-Watchful (Kaldheim Commander Decks)
Silverquill Statement - Breena, the Demagogue (Commander 2021)
Prismari Performance - Zaffai, Thunder Conductor (Commander 2021)
Witherbloom Witchcraft - Willowdusk, Essence Seer (Commander 2021)
Lorehold Legacies - Osgir, the Reconstructor (Commander 2021)
Quantum Quandrix - Adrix and Nev, Twincasters (Commander 2021)
Aura of Courage - Galea, Kindler of Hope (Dungeons & Dragons: Adventures in the Forgotten Realms Commander Decks)
Dungeons of Death - Sefris of the Hidden Ways (Dungeons & Dragons: Adventures in the Forgotten Realms Commander Decks)
Draconic Rage - Vrondiss, Rage of Ancients (Dungeons & Dragons: Adventures in the Forgotten Realms Commander Decks)
Planar Portal - Prosper, Tome-Bound (Dungeons & Dragons: Adventures in the Forgotten Realms Commander Decks)
Coven Counters - Leinore, Autumn Sovereign (Innistrad: Midnight Hunt Commander decks)
Undead Unleashed - Wilhelt, the Rotcleaver (Innistrad: Midnight Hunt Commander decks)
Spirit Squadron - Millicent, Restless Revenant (Innistrad: Crimson Vow Commander decks)
Vampiric Bloodline - Strefan, Maurer Progenitor (Innistrad: Crimson Vow Commander decks)
Buckle Up - Kotori, Pilot Prodigy (Kamigawa: Neon Dynasty Commander decks)
Upgrades Unleashed - Chishiro, the Shattered Blade (Kamigawa: Neon Dynasty Commander decks)
Obscura Operation - Kamiz, Obscura Oculus (Streets of New Capenna Commander decks)
Maestros Massacre - Anhelo, the Painter (Streets of New Capenna Commander decks)
Riveteers Rampage - Henzie "Toolbox" Torre (Streets of New Capenna Commander decks)
Cabaretti Cacophony - Kitt Kanto, Mayhem Diva (Streets of New Capenna Commander decks)
Bedecked Brokers - Perrie, the Pulverizer (Streets of New Capenna Commander decks)
Party Time - Nalia de'Arnise (Commander Legends: Battle for Baldur's Gate Commander Decks)
Mind Flayarrrs - Captain N'ghathrod (Commander Legends: Battle for Baldur's Gate Commander Decks)
Draconic Dissent - Firkraag, Cunning Instigator (Commander Legends: Battle for Baldur's Gate Commander Decks)
Exit from Exile - Faldorn, Dread Wolf Herald (Commander Legends: Battle for Baldur's Gate Commander Decks)
Painbow - Jared Carthalion (Dominaria United Commander Decks)
Legends' Legacy - Dihada, Binder of Wills (Dominaria United Commander Decks)
Forces of the Imperium - Inquisitor Greyfax (Warhammer 40,000 Commander)
Tyranid Swarm - The Swarmlord (Warhammer 40,000 Commander)
The Ruinous Powers - Abaddon the Despoiler (Warhammer 40,000 Commander)
Urza's Iron Alliance - Urza, Chief Artificer (The Brothers' War Commander Decks)
Mishra's Burnished Banner - Mishra, Eminent One (The Brothers' War Commander Decks)
First Flight - Isperia, Supreme Judgment (Starter Commander Decks)
Grave Danger - Gisa and Geralf (Starter Commander Decks)
Chaos Incarnate - Kardur, Doomscourge (Starter Commander Decks)
Draconic Destructions - Atarka, World Render (Starter Commander Decks)
Token Triumph - Emmara, Soul of the Accord (Starter Commander Decks)
Corrupting Influence - Ixhel, Scion of Atraxa (Phyrexia: All Will Be One Commander Decks)
Rebellion Rising - Neyali, Suns' Vanguard (Phyrexia: All Will Be One Commander Decks)
Growing Threat - Brimaz, Blight of Oreskos (March of the Machine Commander Decks)
Cavalry Charge - Sidar Jabari of Zhalfir (March of the Machine Commander Decks)
Call for Backup - Call for Backup (March of the Machine Commander Decks)
Divine Convocation - Kasla, the Broken Halo (March of the Machine Commander Decks)
Tinker Time - Gimbal, Gremlin Prodigy (March of the Machine Commander Decks)
Riders of Rohan - Éowyn, Shieldmaiden (Tales of Middle-Earth Commander Decks, a.k.a. Lord of the Rings Commander Decks)
Food and Fellowship - Frodo, Adventurous Hobbit (Tales of Middle-Earth Commander Decks, a.k.a. Lord of the Rings Commander Decks)
Elven Council - Galadriel, Elven-Queen (Tales of Middle-Earth Commander Decks, a.k.a. Lord of the Rings Commander Decks)
The Hosts of Mordor - Sauron, Lord of the Rings (Tales of Middle-Earth Commander Decks, a.k.a. Lord of the Rings Commander Decks)
Planeswalker Party - Commodore Guff (Commander Masters)
Eldrazi Unbound - Zhulodok, Void Gorger (Commander Masters)
Enduring Enchantments - Anikthea, Hand of Erebos (Commander Masters)
Sliver Swarm - Sliver Gravemother (Commander Masters)
Virtue and Valor - Ellivere of the Wild Court (Wilds of Eldraine Commander Decks)
Fae Dominion - Tegwyll, Duke of Splendor (Wilds of Eldraine Commander Decks)
Blast from the Past - The Fourth Doctor & Sarah Jane Smith (Dr. Who Commander)
Timey-Wimey - The Tenth Doctor & Rose Tyler (Dr. Who Commander)
Masters of Evil - Davros, Dalek Creator (Dr. Who Commander)
Paradox Power - The Thirteenth Doctor & Yasmin Khan (Dr. Who Commander)
Ahoy Mateys - Admiral Brass, Unsinkable (The Lost Caverns of Ixalan Commander Decks)
Blood Rites - Clavileño, First of the Blessed (The Lost Caverns of Ixalan Commander Decks)
Explorers of the Deep - Hakbal of the Surging Soul (The Lost Caverns of Ixalan Commander Decks)
Veloci-RAMP-Tor - Pantlaza, Sun-Favored (The Lost Caverns of Ixalan Commander Decks)
Deadly Disguise - Kaust, Eyes of the Glade (Murders at Karlov Manor Commander Decks)
Revenant Recon - Mirko, Obsessive Theorist (Murders at Karlov Manor Commander Decks)
Deep Clue Sea - Morska, Undersea Sleuth (Murders at Karlov Manor Commander Decks)
Blame Game - Nelly Borca, Impulsive Accuser (Murders at Karlov Manor Commander Decks)
Scrappy Survivors - Dogmeat, Ever Loyal (Fallout Commander)
Science! - Dr. Madison Library (Fallout Commander)
Hail, Caesar - Caesar, Legion's Emperor (Fallout Commander)
Mutant Menace - The Wise Mothman (Fallout Commander)
Desert Bloom - Yuma, Proud Protector (Outlaws of Thunder Junction Commander Decks, a.k.a. Thunder Junction Commander)
Quick Draw - Stella Lee, Wild Card (Outlaws of Thunder Junction Commander Decks, a.k.a. Thunder Junction Commander)
Most Wanted - Olivia, Opulent Outlaw (Outlaws of Thunder Junction Commander Decks, a.k.a. Thunder Junction Commander)
Grand Larceny - Gonti, Canny Acquisitor (Outlaws of Thunder Junction Commander Decks, a.k.a. Thunder Junction Commander)
Creative Energy - Satya, Aetherflux Genius (Modern Horizons III)
Tricky Terrain - Omo, Queen of Vesuva (Modern Horizons III)
Graveyard Overdrive - Disa the Restless (Modern Horizons III)
Eldrazi Incursion - Ulalek, Fused Atrocity (Modern Horizons III)
Family Matters - Zinnia, Valley's Voice (Bloomburrow)
Peace Offering - Ms. Bumbleflower (Bloomburrow)
Animated Army - Bello, Bard of the Brambles (Bloomburrow)
Squirreled Away - Hazel of the Rootbloom (Bloomburrow)
Head I Win, Tails You Lose - Zndrspit, Eye of Wisdom / Okaun, Eye of Chaos (Secret Lair 2021 commander)
From Cute to Brute - Esika, God of the Tree // The Prismatic Bridge (Secret Lair Commander)
Angels: They're Just Like Us but Cooler and with Wings - Bruna, the Fading Light (Secret Lair Commander)
Raining Cats & Dogs - Rin and Seri, Inseperable (Secret Lair Commander)
20 Ways to Win (Secret Lair Commander)